阿胶	食材
鹌鹑	食材
白菜	食材
白酒	食材
百合	食材
板粟	食材
菠菜	食材
菠萝	食材
菜花	食材
蚕豆	食材
糙米	食材
草莓	食材
草鱼	食材
茶	食材
蛏子	食材
橙子	食材
葱	食材
大豆油	食材
大米	食材
大枣	食材
带鱼	食材
动物血	食材
鹅肉	食材
蜂蜜	食材
甘蔗	食材
柑橘	食材
橄榄油	食材
桂圆	食材
哈密瓜	食材
蛤蜊	食材
海带	食材
旱芹	食材
荷叶	食材
核桃	食材
黑大豆	食材
黑豆	食材
黑米	食材
黑木耳	食材
黑芝麻	食材
红豆	食材
红薯	食材
猴头菌	食材
胡椒	食材
胡萝卜	食材
胡荽	食材
胡桃仁	食材
花椒	食材
花生	食材
花生油	食材
化橘红	食材
槐花	食材
黄大豆	食材
黄豆	食材
黄瓜	食材
黄精	食材
黄酒	食材
黄芪	食材
黄鱼	食材
茴香	食材
火麻仁	食材
藿香	食材
鸡蛋	食材
鸡肝	食材
鸡内金	食材
鸡肉	食材
鸡腿菇	食材
鸡血藤	食材
荠菜	食材
鲫鱼	食材
甲鱼	食材
姜	食材
姜黄	食材
豇豆	食材
酱油	食材
茭白	食材
芥菜	食材
芥子	食材
金银花	食材
金樱子	食材
金针菜	食材
金针菇	食材
粳米	食材
韭菜	食材
酒	食材
桔梗	食材
菊花	食材
菊苣	食材
橘	食材
决明子	食材
蕨	食材
咖啡	食材
咖喱	食材
开心果	食材
空心菜	食材
苦瓜	食材
苦菊	食材
苦杏仁	食材
葵花油	食材
葵花子	食材
昆布	食材
辣椒	食材
莱菔子	食材
梨	食材
李子	食材
鲤鱼	食材
鳢鱼	食材
荔枝	食材
栗子	食材
莲藕	食材
莲子	食材
灵芝	食材
菱	食材
榴莲	食材
芦根	食材
芦荟	食材
芦笋	食材
鲈鱼	食材
鹿鞭	食材
鹿茸	食材
鹿肉	食材
罗汉果	食材
萝卜	食材
落花生	食材
落葵	食材
驴肉	食材
绿豆	食材
绿豆芽	食材
麻油	食材
马齿苋	食材
马铃薯	食材
马乳	食材
麦门冬	食材
麦芽	食材
芒果	食材
猫肉	食材
毛笋	食材
玫瑰花	食材
猕猴桃	食材
蘑菇	食材
墨鱼	食材
牡丹皮	食材
牡蛎	食材
木耳	食材
木瓜	食材
木香	食材
奶类	食材
南瓜	食材
南瓜子	食材
泥鳅	食材
柠檬	食材
牛鞭	食材
牛肚	食材
牛肉	食材
牛乳	食材
牛髓膏	食材
糯米	食材
女贞子	食材
藕	食材
蟠桃果	食材
螃蟹	食材
胖大海	食材
佩兰	食材
枇杷	食材
啤酒	食材
平贝母	食材
平鱼	食材
苹果	食材
葡萄	食材
蒲公英	食材
芡实	食材
荞麦	食材
茄子	食材
芹菜	食材
青果	食材
青椒	食材
青梅	食材
雀	食材
人参	食材
肉苁蓉	食材
肉豆蔻	食材
肉桂	食材
三七	食材
三文鱼	食材
桑椹	食材
桑叶	食材
沙棘	食材
砂仁	食材
山茶油	食材
山柰	食材
山药	食材
山楂	食材
山茱萸	食材
鳝鱼	食材
生菜	食材
生地黄	食材
生姜	食材
石斛	食材
石决明	食材
石榴	食材
石首鱼	食材
食醋	食材
食盐	食材
柿子	食材
熟地黄	食材
水	食材
水芹	食材
丝瓜	食材
松子	食材
菘菜	食材
粟米	食材
酸枣仁	食材
蒜	食材
锁阳	食材
太子参	食材
糖	食材
桃	食材
桃仁	食材
天麻	食材
甜瓜	食材
茼蒿	食材
土豆	食材
土茯苓	食材
兔肉	食材
菟丝子	食材
豌豆	食材
味精	食材
文蛤肉	食材
蕹菜	食材
莴苣	食材
莴笋	食材
乌骨鸡	食材
乌梅	食材
乌梅粥	食材
乌梢蛇	食材
乌贼鱼	食材
芜菁	食材
五加皮	食材
西瓜	食材
西红花	食材
西红柿	食材
西葫芦	食材
西洋参	食材
虾	食材
夏枯草	食材
苋	食材
香附	食材
香菇	食材
香蕉	食材
香薷	食材
香油	食材
香橼	食材
小白菜	食材
小茴香	食材
小麦	食材
小米	食材
薤白	食材
蟹	食材
杏	食材
杏子	食材
鸭蛋	食材
鸭肉	食材
延年草	食材
燕麦	食材
燕窝	食材
羊骨	食材
羊肉	食材
羊乳	食材
杨桃	食材
洋葱	食材
腰果	食材
椰子	食材
野猪肉	食材
益母草	食材
薏苡仁	食材
银耳	食材
银鱼	食材
淫羊藿	食材
樱桃	食材
油菜	食材
鱿鱼	食材
柚	食材
余甘子	食材
鱼翅	食材
鱼腥草	食材
玉米	食材
玉米油	食材
玉蜀黍	食材
玉竹	食材
郁金	食材
郁李仁	食材
芸薹	食材
泽泻	食材
芝麻	食材
栀子	食材
猪肚	食材
猪肺	食材
猪肝	食材
猪肉	食材
猪肾	食材
猪蹄	食材
猪心	食材
猪血	食材
竹荪	食材
竹笋	食材
孜然	食材
紫菜	食材
紫河车	食材
紫苏	食材
紫苏子	食材
冬瓜	食材
动物肝脏	食材
红葡萄酒	食材
鼻渊	疾病
痹证	疾病
便秘	疾病
不寐	疾病
不孕症	疾病
产后恶露不绝	疾病
产后缺乳	疾病
颤证	疾病
喘证	疾病
带下病	疾病
盗汗	疾病
癫狂	疾病
疔疮	疾病
呃逆	疾病
耳鸣、耳聋	疾病
肥胖	疾病
肺痨	疾病
肺胀	疾病
粉刺	疾病
风瘙痒	疾病
附骨疽	疾病
疳证	疾病
感冒	疾病
佝偻病	疾病
鼓胀	疾病
咳嗽	疾病
黄疸	疾病
积聚	疾病
积滞	疾病
精癃	疾病
精浊	疾病
痉证	疾病
厥证	疾病
口臭;出气臭;口气秽恶;口气臭;臭息	疾病
口疮;口腔溃疡	疾病
淋证	疾病
流痰	疾病
瘤与岩	疾病
癃闭	疾病
瘰疬	疾病
绿风内障;绿风;绿盲;绿水灌珠	疾病
男性不育症	疾病
内伤发热	疾病
疟疾	疾病
呕吐	疾病
青风内障;青风;青风障症	疾病
乳癖	疾病
乳痈	疾病
湿疮	疾病
视瞻有色;视直如曲;视小为大	疾病
术前与术后	疾病
水痘	疾病
水肿	疾病
痛经	疾病
头痛	疾病
痿证	疾病
胃痛	疾病
消渴	疾病
小儿口疮	疾病
哮病	疾病
胁痛	疾病
泄泻	疾病
心悸	疾病
胸痹	疾病
虚劳	疾病
眩晕	疾病
血证	疾病
厌食	疾病
阳痿	疾病
腰痛	疾病
噎膈	疾病
夜盲;雀目;鸡盲	疾病
遗精	疾病
遗尿	疾病
隐疹	疾病
瘿病	疾病
痈	疾病
有头疽	疾病
郁证	疾病
月经不调	疾病
早泄	疾病
痄腮	疾病
痔	疾病
中耳炎;风耳;气闭耳聋	疾病
中风	疾病
自汗	疾病
补血养阴	功效
润燥安胎	功效
利水消肿	功效
益中利气	功效
补益五脏	功效
清热解毒	功效
防止便秘	功效
养颜护肤	功效
防癌抗癌	功效
消麻解乏	功效
使人轻松	功效
活血通脉	功效
润肺止咳	功效
宁心安神	功效
美容养颜	功效
清热凉血	功效
养胃健脾	功效
补肾强筋	功效
活血止血	功效
滋阴补血	功效
通利五脏	功效
清热解暑	功效
消食止泻	功效
益气健脾	功效
利湿消肿	功效
止血降压	功效
涩精止带	功效
益气和中	功效
除湿气	功效
整肠利便	功效
降血脂	功效
减肥	功效
润肺生津	功效
健脾和胃	功效
补气益血	功效
凉血解毒	功效
暖胃和中	功效
平降肝阳	功效
祛风治痹	功效
强心利尿	功效
抗菌消炎	功效
收敛止泻	功效
清热	功效
除烦	功效
补虚	功效
利尿	功效
去湿	功效
生津止渴	功效
开胃宽胸	功效
止呕	功效
通阳发表	功效
解毒止痛	功效
祛痰	功效
增强食欲	功效
抗肠脉硬化	功效
滋润肌肤	功效
抗衰老	功效
健脾养胃	功效
止渴除烦	功效
固肠止泻	功效
补中益气	功效
养血安神	功效
缓和药性	功效
补脾益气	功效
养肝补血	功效
预防心血管疾病	功效
解喜清肠	功效
补血美容	功效
益气补虚	功效
暖胃开津	功效
养精血	功效
防衰老	功效
健康体魄	功效
补中缓急	功效
润肠通便	功效
解毒	功效
除热止渴	功效
和中	功效
行水	功效
开胃理气	功效
止渴润肺	功效
止咳化痰	功效
健胃消食	功效
降低血脂	功效
美容护肤	功效
益心脾	功效
安神	功效
清暑除烦	功效
止渴利尿	功效
滋阴润燥	功效
利尿消肿	功效
软坚散结	功效
软坚化痰	功效
祛湿止痒	功效
清热利水	功效
破积软坚	功效
理气润肠	功效
平肝	功效
祛风	功效
利水	功效
止血	功效
清暑化湿	功效
升发清阳	功效
凉血止血	功效
收涩化瘀止血	功效
温补肺肾	功效
定喘润肠	功效
健脾益肾	功效
活血利水	功效
祛风解毒	功效
除热	功效
调中下气	功效
补肾固精	功效
养血	功效
滋阴补肾	功效
健职暖计	功效
明口活血	功效
调理肠胃	功效
滋润强壮	功效
清肺益气	功效
补血活血	功效
镇静止痛	功效
补益肝肾	功效
养血益精	功效
除热毒	功效
散恶血	功效
消胀	功效
利小便	功效
下腹胀满	功效
小便不利	功效
和血补中	功效
宽肠通便	功效
益气生津	功效
抗癌	功效
温中散寒	功效
下气消痰	功效
理气上痛	功效
祛腥气	功效
解油腻	功效
健脾和中	功效
滋肝明目	功效
化痰止咳	功效
健脾消食	功效
补肝明目	功效
降气止咳	功效
发汗透疹	功效
补肾益精	功效
温肺定喘	功效
温中止痛	功效
杀虫止痒	功效
除湿止泻	功效
除湿止痛	功效
杀虫解毒	功效
止痛解腥	功效
散淤	功效
消肿	功效
润肺和胃	功效
敛肺让咳	功效
降脂降压	功效
润燥滑肠	功效
去积	功效
滑肠下结	功效
理气宽中	功效
燥湿化痰	功效
清肝泻火	功效
健脾利水	功效
宽中导滞	功效
解毒消肿	功效
促进消化吸收	功效
清利大小便	功效
解热润肺	功效
宽中下	功效
润肺滋阴	功效
补血养颜	功效
活血祛寒	功效
预防感冒	功效
补气升阳	功效
益卫固表	功效
托毒生肌	功效
和胃止血	功效
益肾补虚	功效
散寒	功效
健胃	功效
行气	功效
止痛	功效
暖肝	功效
滋养补虚	功效
祛暑解表	功效
化湿和胃	功效
养血安胎	功效
补肝益肾	功效
养血明目	功效
消疳杀虫	功效
涩精止遗	功效
通淋化石	功效
温中益气	功效
补精填髓	功效
滋补血液	功效
具有益胃清神	功效
增进食欲	功效
消食化积	功效
活血舒筋	功效
养血调经	功效
凉肝止血	功效
平肝明目	功效
清热利湿	功效
通血脉	功效
补脾健胃	功效
通乳	功效
除湿利水	功效
活血通络	功效
滋阴凉血	功效
滋补肝肾	功效
补益调中	功效
发表散寒	功效
温胃止呕	功效
破血行气	功效
通经止痛	功效
健脾利湿	功效
补肾涩精	功效
健脾补肾	功效
泻痢	功效
吐逆	功效
解热除烦	功效
降低胆固醇	功效
解热毒	功效
除烦止渴	功效
利二便	功效
利肺豁痰	功效
消肿散结	功效
温肺豁痰利窍	功效
散结通络止痛	功效
疏散风热	功效
固精缩尿	功效
固崩止带	功效
涩肠止泻	功效
宽胸解郁	功效
增强体质	功效
调中和胃	功效
渗湿止泻	功效
温中	功效
散瘀	功效
温中开胃	功效
行气活血	功效
补肾助阳	功效
调和脏腑	功效
行药势	功效
开宣肺气	功效
祛痰利咽	功效
排脓	功效
平抑肝阳	功效
清肝明目	功效
清肝利胆	功效
生津润肺	功效
理气化痰	功效
开胃醒酒	功效
止嗽	功效
止痢	功效
疏肝解郁	功效
降气化痰	功效
抑制肝癌	功效
消除疲劳	功效
恢复体力	功效
振奋精神	功效
活血	功效
利汗排毒	功效
驱湿散寒	功效
外生杀菌	功效
和胃止痛	功效
益肾强体	功效
延缓衰老	功效
凉血利尿	功效
祛暑涤热	功效
明目	功效
清热祛火	功效
解毒明目	功效
补气益精	功效
止渴消署	功效
止咳平喘	功效
降血压	功效
养颜美容	功效
补血	功效
消痰软坚	功效
利水退肿	功效
下气消食	功效
开胃消食	功效
改善食欲	功效
减肥美容	功效
消食除胀	功效
清热降火	功效
清心除烦	功效
解酒	功效
清心润肺	功效
养阴清热	功效
健脾祛湿	功效
利尿通便	功效
清喉降火	功效
醒酒解毒	功效
清肝涤热	功效
生津液	功效
利水下气	功效
安胎	功效
止咳	功效
养血健脾	功效
行气消肿	功效
益气补血	功效
活血消肿	功效
散瘀止泻	功效
健脾生肌	功效
益血止血	功效
补脾止泻	功效
益肾固精	功效
养心安神	功效
益肾涩精	功效
益气血	功效
健脾胃	功效
健脾益胃	功效
滋阴强壮	功效
疏风清热	功效
利胆退黄	功效
清热泻火	功效
除烦止呕	功效
瘦身减肥	功效
清热生津	功效
利水通淋	功效
健脾	功效
益肾	功效
益精填髓	功效
壮肾阳	功效
益精血	功效
强筋骨	功效
托疮毒	功效
益气养血	功效
清热润肺	功效
生津利咽	功效
消食	功效
下气	功效
化痰	功效
解渴	功效
下气宽中	功效
化痰清热	功效
润肺化痰	功效
滑肠通便	功效
消暑	功效
清热消暑	功效
解毒利尿	功效
解毒生肌	功效
凉血止痢	功效
除湿通淋	功效
消肿解毒	功效
养血润燥	功效
清热止渴	功效
润肺养阴	功效
益胃生津	功效
回乳消胀	功效
益胃止呕	功效
解渴利尿	功效
祛风湿	功效
解毒散结	功效
透疹	功效
活血止痛	功效
调中理气	功效
生津润燥	功效
健脾开胃	功效
平肝提神	功效
养血通经	功效
补脾益肾	功效
活血化瘀	功效
平肝息风	功效
重镇安神	功效
舒筋活络	功效
和胃化湿	功效
平肝舒筋	功效
行气止痛	功效
益师胃	功效
生津润肠	功效
解毒杀虫	功效
降糖止渴	功效
杀虫	功效
补益脾肾	功效
利尿除湿	功效
祛暑	功效
和胃安胎	功效
消食化痰	功效
祛暑安胎	功效
固元益精	功效
散寒止痛	功效
强生物	功效
益肺胃	功效
健脾止泻	功效
缩尿	功效
敛汗	功效
益气固表	功效
清热明目	功效
凉血	功效
美颜乌发	功效
益阴补髓	功效
清热散淤	功效
续筋接骨	功效
利咽开音	功效
解暑化湿	功效
辟秽和中	功效
和胃降逆	功效
强心	功效
镇痛	功效
消暑降温	功效
软化血管	功效
舒筋利骨	功效
止渴	功效
除烦醒酒	功效
润肺除烦	功效
养心益气	功效
润肠止泻	功效
清热解署	功效
强壮筋骨	功效
软坚散寒	功效
补肝利胆	功效
通利小便	功效
滋阴生津	功效
强筋健骨	功效
利湿通淋	功效
固肾涩精	功效
补脾祛湿	功效
止泻	功效
健脾消积	功效
下气宽肠	功效
解毒敛疮	功效
降压	功效
平衡血压	功效
利咽化痰	功效
散寒除湿	功效
缓解疲劳	功效
预防坏血病	功效
利筋脉	功效
固涩益精	功效
大补元气	功效
复脉固脱	功效
补益脾肺	功效
生津养血	功效
温中行气	功效
补火助阳	功效
引火归元	功效
温通经脉	功效
化瘀止血	功效
消肿定痛	功效
补虚强壮	功效
温定	功效
消肿散毒	功效
滋阴养血	功效
清肺润燥	功效
活血散瘀	功效
化湿开胃	功效
温脾止泻	功效
理气安胎	功效
抵抗衰老	功效
行气温中	功效
生津益肺	功效
消食健胃	功效
化痰消滞	功效
收敛固涩	功效
温阳健脾	功效
补益气血	功效
祛风通络	功效
利五脏	功效
通经脉	功效
清胃热	功效
镇痛催眠	功效
减肥瘦身	功效
养阴生津	功效
解表散寒	功效
温中止呕	功效
解鱼蟹毒	功效
生津养胃	功效
滋阴清热	功效
润肺益肾	功效
平肝潜阳	功效
镇咳消痰	功效
消食杀毒	功效
除饮止痛	功效
抑菌和杀菌	功效
保护皮肤、头发	功效
醒酒	功效
清火	功效
催呕、除痰	功效
调味和中	功效
润燥通便	功效
涩肠	功效
消宿血	功效
美白	功效
降压止血	功效
用于肺燥咳嗽	功效
养血滋阴	功效
清热祛痰	功效
促进新陈代谢	功效
调节体温	功效
清理肠胃	功效
清热化痰	功效
解暑除烦	功效
通经活络	功效
养液	功效
熄风	功效
润肺	功效
滑肠	功效
清肺消痰	功效
通利肠胃	功效
养心补肝	功效
敛汗生津	功效
温中消食	功效
补气健脾	功效
肺生津润	功效
活血消积	功效
润肤色	功效
生津	功效
润肠	功效
消积	功效
活血祛瘀	功效
息风止痉	功效
清暑热	功效
解烦渴	功效
化瘀散结	功效
驱虫等	功效
和脾胃	功效
消痰饮	功效
调经止痛	功效
焕发精神	功效
通利关节	功效
健脾补中	功效
补阳益阴	功效
明目止泻	功效
和中下气	功效
通乳利水	功效
益脾和胃	功效
增鲜开胃	功效
醒脑镇惊	功效
滋补	功效
开胃	功效
助消化	功效
增强记忆力	功效
润燥止渴	功效
软坚消肿	功效
凉血清热	功效
利湿解毒	功效
清热利尿	功效
退虚热	功效
敛肺止咳	功效
涩肠止泄	功效
通络	功效
止痉	功效
消食下气	功效
解郁安神	功效
养阴凉血	功效
提高食淡	功效
补气养阴	功效
壮阳补肾	功效
散结消肿	功效
治疗旁疮	功效
通利二便	功效
理气调中	功效
扶正补虚	功效
祛风透疹	功效
化痰理气	功效
益胃和中	功效
滋味助食	功效
润肺滑肠	功效
润肠解毒	功效
养胃抑菌	功效
降压降糖	功效
发汗解表	功效
化湿和中	功效
疏肝理气	功效
宽中	功效
清热除烦	功效
行气祛淤	功效
通利胃肠	功效
理气和胃	功效
养心	功效
健胃除湿	功效
和胃安眠	功效
滋养肾气	功效
通阳散结	功效
行气导滞	功效
清热散瘀	功效
止咳定喘	功效
润肺定喘	功效
滋阴平肝	功效
清肺止咳	功效
滋阴养胃	功效
补血行水	功效
养胃生津	功效
通腑行滞	功效
活血补气	功效
补益脾胃	功效
滑肠催产	功效
降胆固醇	功效
养阴润肺	功效
益气补中	功效
健脾温中	功效
补虚润燥	功效
和胃	功效
下气和中	功效
生津正渴	功效
利尿通淋	功效
健胃理气	功效
提神健体	功效
散淤解毒	功效
排毒养顾	功效
催乳	功效
消疳	功效
利湿	功效
止痒	功效
杀虫清	功效
清暑降温	功效
生津利尿	功效
滋补五脏	功效
润养肌肤	功效
活血调经	功效
利水渗湿	功效
健脾除痹	功效
消肿排脓	功效
滋补生津	功效
润肺养胃	功效
补肺益气	功效
养阴润燥	功效
宽中健胃	功效
补虚利尿	功效
祛风除湿	功效
调中补气	功效
益肾健脾	功效
活血化淤	功效
强身健体	功效
祛火清热	功效
消食和胃	功效
生津止咳	功效
益气滋阴	功效
补虚壮腰	功效
行水化痰	功效
促进生长	功效
增强免疫力	功效
消痈排脓	功效
补中开胃	功效
益肺宁心	功效
止痛通便	功效
减少动脉硬化	功效
抵御心血管疾病	功效
防止动脉硬化	功效
调中开胃	功效
滋阴润肺	功效
行气解郁	功效
凉血清心	功效
凉血散血	功效
渗湿泄热	功效
助脾长肌	功效
润肌肤	功效
泻火除烦	功效
补肺止咳	功效
养肝明目	功效
补肾滋阴	功效
滋养脏腑	功效
滑润肌肤	功效
通乳汁	功效
补血养心	功效
补血止血	功效
养心镇惊	功效
息风	功效
开胃健脾	功效
宽胸利眼	功效
通肠排便	功效
开隔豁痰	功效
消油腻	功效
解酒毒	功效
醒脑通脉	功效
降火平肝	功效
驱寒除湿	功效
理气开胃	功效
驱风止痛	功效
化痰软坚	功效
利咽止咳	功效
养心除烦	功效
利水除湿	功效
清肺化痰	功效
养肺定喘	功效
行气和中	功效
降气消痰	功效
香菇镶双鲜	食谱
黑芝麻双米粥	食谱
山参鹌鹑汤	食谱
生菜鹌鹑蛋包	食谱
香菇白菜	食谱
奶汁嫦白菜	食谱
芥末白菜	食谱
白菜豆腐皮红枣汤	食谱
猪肉白菜百叶汤	食谱
百合炒里脊	食谱
百合冬瓜汤	食谱
百合饮	食谱
板栗烧鸡	食谱
板栗羹	食谱
板栗乳鸽	食谱
菠菜羊肝汤	食谱
牛奶炖菠菜	食谱
菠菜拌黑木耳	食谱
菠菜枸杞子粥	食谱
葛笋苹果菠萝汁	食谱
白菜菠萝卷	食谱
菠萝汁	食谱
菠萝膏	食谱
芙蓉菜花	食谱
西兰花浓汤	食谱
胡萝卜炒菜	食谱
西红柿玉米西兰花	食谱
金钩菜花	食谱
蚕豆炖豆腐	食谱
香菇栗子炒蚕豆	食谱
玫瑰蚕豆花茶	食谱
蚕豆红枣汤	食谱
蚕豆水	食谱
十米粥	食谱
糙米圆白菜卷	食谱
薏仁糙米粥	食谱
草莓橘瓣饮	食谱
草莓红枣粥	食谱
奶油草莓	食谱
冰糖草莓	食谱
红糖草莓	食谱
紫菜鱼卷	食谱
草鱼豆腐	食谱
草鱼冬瓜汤	食谱
核桃草鱼火锅	食谱
红豆相思茶	食谱
西湖龙井虾	食谱
绿茶娃娃菜	食谱
连翘牛劳茶	食谱
金橘叶绿茶	食谱
甜橙米酒汁	食谱
橙子饼	食谱
柳橙菊花汁	食谱
葱烧海参	食谱
葱鼓汤	食谱
葱醋粥	食谱
大葱红枣汤	食谱
鲜奶玉液	食谱
皮蛋腐竹咸肉粥	食谱
蜜汁大米花生粥	食谱
菊花粥	食谱
葛根粉粥	食谱
大枣粥	食谱
花生衣红枣汁	食谱
参枣米饭	食谱
大枣牛肝汤	食谱
党参红枣茶	食谱
红烧带鱼	食谱
木瓜带鱼汤	食谱
蜀香带鱼	食谱
带鱼女贞子汁	食谱
萝卜丝烧带鱼	食谱
冬瓜排骨汤	食谱
冬瓜炒蒜苗	食谱
虾油冬瓜卷	食谱
冬瓜银耳羹	食谱
冬瓜荷叶汤	食谱
猪肝菠菜汤	食谱
豆腐猪肝汤	食谱
鸡肝荸荠蒸肉饼	食谱
首乌猪肝片	食谱
人参炖老鹅	食谱
双仁煲鹅肉	食谱
补阴汤	食谱
补血汤	食谱
蜂蜜麻糖	食谱
蜜汁花生奶粥	食谱
蜂蜜萝卜汁	食谱
蜜糖银花露	食谱
橘饼奶耳羹	食谱
橘子羹	食谱
橘皮粥	食谱
蔬菜豆腐蛋饼	食谱
橄榄油鲜蘑配西红柿	食谱
橄榄油银耳花生黄瓜丁	食谱
口服橄榄油	食谱
桂圆鸡	食谱
山参桂圆银耳汤	食谱
洋参桂圆蜜饮	食谱
补血膏	食谱
酸奶水果布丁	食谱
哈蜜瓜百合瘦身汤	食谱
山药哈密瓜饺子	食谱
凉拌海带丝	食谱
海带冬瓜豆瓣汤	食谱
草决明海带汤	食谱
海带炖黑豆	食谱
海藻总汇汤	食谱
核桃瘦肉汤	食谱
核桃山药炖乳鸽	食谱
核桃仁山植汤	食谱
复元汤	食谱
狗肉煨黑豆	食谱
红枣黑豆炖鲤鱼	食谱
黑芝麻黑豆泥嫩汤	食谱
黑豆饮	食谱
仙人首乌粥	食谱
黑米双豆糕	食谱
黑米豌豆饭	食谱
黑米阿胶粥	食谱
党参山植黑米粥	食谱
黑木耳红枣粥	食谱
黑木耳炒肉片	食谱
黑木耳当归汤	食谱
首乌肝片	食谱
红豆紫米汤	食谱
红豆相思茶点	食谱
红豆孽莽煲乌鸡	食谱
红豆排骨汤	食谱
莲子百合红豆沙	食谱
红葡萄酒果冻	食谱
红酒浸雪梨	食谱
樱桃糖酒汁	食谱
红酒炖梨	食谱
葡萄酒王浆饮	食谱
红薯甜点	食谱
粉蒸肥肠	食谱
红薯粳米粥	食谱
胡椒萝卜汤	食谱
牛蛙胡椒粉	食谱
生姜胡椒豆蔻蒸鲫鱼	食谱
胡萝卜香泥	食谱
橙子胡萝卜汁	食谱
辣椒生姜胡萝卜汁	食谱
胡萝卜煲羊肉	食谱
胡萝卜鱼肉煲	食谱
花椒粳米粥	食谱
花椒鱼片	食谱
干姜花椒粥	食谱
花椒绿豆汤	食谱
花生红枣鸡	食谱
油花生酱沙拉	食谱
黄豆炖鳞鱼	食谱
豆浆炖羊肉	食谱
豆腐肉丸汤	食谱
豆芽海带汤	食谱
黄豆芽煲墨鱼	食谱
丹参黄豆汁	食谱
黄豆猪排汤	食谱
红枣枸杞子豆浆	食谱
黄瓜雪梨粥	食谱
山楂汁拌黄瓜	食谱
黄瓜蒲公英粥	食谱
蜜饯黄瓜	食谱
干蒸黄鱼	食谱
老咸菜烧黄鱼	食谱
芦笋黄鱼蕾	食谱
花果黄鱼	食谱
白菜鸡肉包	食谱
咖喱鸡块	食谱
红颜汤	食谱
滑蛋韭香炒银鱼	食谱
归参炖母鸡	食谱
黄芪乌鸡	食谱
菠萝炒鸡片	食谱
何首乌煮鸡蛋	食谱
鲫鱼豆腐汤	食谱
鲫鱼川贝汤	食谱
乌豆煲鲫鱼汤	食谱
郁金煮鲫鱼	食谱
老干妈烧甲鱼	食谱
山药桂圆炖甲鱼	食谱
甲鱼香菇煲	食谱
黄芪煲甲鱼	食谱
清炖甲鱼	食谱
川椒炒姜芽	食谱
秘制子姜鸡	食谱
姜茶	食谱
参姜粥	食谱
酸豇豆炒肉末	食谱
海米蛇豇豆	食谱
梅干菜炒豇豆	食谱
姜汁豇豆	食谱
香油金针菇	食谱
鸡汁金针菇炒双耳	食谱
金针菇拌肚丝	食谱
红零冬菇汤	食谱
猴头炖金针	食谱
韭菜炒核桃虾仁	食谱
韭菜炒鸭肠	食谱
韭菜汁	食谱
韭菜菜煮蛤肉	食谱
山楂扁豆韭菜饮	食谱
咖喱米粉	食谱
藏式咖喱牛肉面	食谱
咖喱红薯鸡块	食谱
空心菜腐乳炒文蛤	食谱
凉拌空心菜	食谱
肉沫空心菜	食谱
空心菜鱼脑石饮	食谱
空心菜马蹄煲排骨汤	食谱
苦瓜拌芹菜	食谱
苦瓜焖鸡翅	食谱
苦瓜茶	食谱
秀菊苦瓜	食谱
苦瓜水	食谱
荷包尖椒	食谱
辣椒炒螺蛳	食谱
辣椒生姜粥	食谱
辣椒炖蛇肉	食谱
辣椒叶蛋汤	食谱
红酒蜜梨	食谱
水梨西红柿汁	食谱
冰糖萝卜梨	食谱
获苓贝梨	食谱
燕窝梨汤	食谱
杏豆鲤鱼	食谱
黑豆鲤鱼汤	食谱
当归鲤鱼汤	食谱
催乳鲤鱼汤	食谱
荔枝莲藕羹	食谱
荔枝山药莲米粥	食谱
人参荔枝酒	食谱
荔枝枣糖	食谱
莲藕甘蔗汁	食谱
五样同饮	食谱
冬瓜莲子粥	食谱
山药参枣糯米粥	食谱
菱角莲子红枣羹	食谱
莲子心甘草茶	食谱
芦萎什锦沙拉	食谱
芦荟虾仁	食谱
芦萎馅饼	食谱
蜜糖芦荟露	食谱
冰晶芦荟拌银耳	食谱
香烹鲈鱼	食谱
麒麟鲈鱼	食谱
清蒸鲈鱼	食谱
白萝卜煲羊脯	食谱
萝卜酸梅汤	食谱
白萝卜炖蜂蜜	食谱
绿豆海带薏仁汤	食谱
绿豆枣仁莲藕汤	食谱
绿豆炖老鸭	食谱
绿豆车前草蜜饮	食谱
绿豆决明子汤	食谱
鱼肉芒果咖哩汤	食谱
芒果减肥茶	食谱
芒果椰汁黑糯米	食谱
芒果龟苓膏	食谱
芒果陈皮瘦肉汤	食谱
猕猴桃粥	食谱
猕猴桃酒	食谱
猕猴桃蜂蜜饮	食谱
猕猴桃根猪瘦肉汤	食谱
猕猴桃薄荷汁	食谱
木瓜银耳汤	食谱
木瓜牛奶	食谱
木瓜鸡爪	食谱
木瓜花生猪尾汤	食谱
奶酪拌鲑鱼	食谱
虾仁炒牛奶	食谱
羊肉奶羹	食谱
肉茸玉米羹	食谱
姜韭牛奶羹	食谱
什锦水果汤	食谱
糖醋南瓜丸	食谱
冰汁南瓜	食谱
南瓜饼	食谱
南瓜灵芝羹	食谱
糖蜜南瓜子	食谱
柠檬甜汁茶	食谱
苹果柠檬汁	食谱
柠檬汁拌苹果蜜	食谱
土豆牛肉	食谱
黑胡椒牛柳	食谱
陈皮牛肉	食谱
糯米百合粥	食谱
美味黄豆糯米粥	食谱
糯米藕片	食谱
红花糯米粥	食谱
糯米内金粥	食谱
葱姜炒螃蟹	食谱
爆炒泰式芙蓉蟹	食谱
螃蟹山楂散	食谱
蟹壳鱼翅汤	食谱
苹果甜椒拼盘	食谱
猪心苹果卷	食谱
苹果蜂蜜饮	食谱
藿香苹果茶	食谱
山莲葡萄粥	食谱
葡萄藕地蜜汁	食谱
人参葡萄酒	食谱
养麦面疙瘩汤	食谱
彩色面片	食谱
养麦粥	食谱
炸茄饼	食谱
鱼香茄子	食谱
海棠花蒸茄子	食谱
甘草大蒜烧茄子	食谱
热饮芹菜汁	食谱
芹菜苹果汁	食谱
花生仁拌芹菜	食谱
芹菜橘皮	食谱
蜂蜜芹菜汁	食谱
青椒香干炒毛豆	食谱
青椒蔬果汁	食谱
杞叶青椒块	食谱
萝卜三文鱼头汤	食谱
姜葱三文鱼	食谱
蜜汁煎三文鱼	食谱
砂锅人参三文鱼头	食谱
菠菜山药汤	食谱
西红柿炒山药	食谱
山药莲藕桂花汤	食谱
山药酒	食谱
大枣山药桂圆粥	食谱
蚝油生菜	食谱
生菜苹果汁	食谱
腐乳生菜	食谱
坚果生菜沙拉	食谱
果味椒辣盐白菜	食谱
椒盐爆中虾	食谱
双叶盐汤	食谱
盐水黑豆	食谱
虾酱焖丝瓜	食谱
西红柿丝瓜汤	食谱
素炒丝瓜	食谱
桂花丝瓜	食谱
生丝瓜汁	食谱
蒜拌海肠	食谱
蒜香茄子	食谱
蒜汁酒	食谱
花生赤豆枣蒜汤	食谱
独蒜牛奶羹	食谱
糖水樱桃	食谱
杭菊糖茶	食谱
杏仁芝麻糖	食谱
冰糖杏仁糊	食谱
冰糖黄精汤	食谱
炸桃片	食谱
鲜桃葡萄羹	食谱
桃仁芝麻蜜糖	食谱
新鲜桃花蜜	食谱
生拌茼蒿	食谱
蓬蒿汁	食谱
茼蒿炒猪心	食谱
冰糖茼蒿	食谱
茼蒿汁	食谱
茼蒿汁菊花饮	食谱
椒荷烧土豆	食谱
西红柿土豆排骨汤	食谱
糖醋酥豌豆	食谱
糙米豌豆饭	食谱
豌豆鸡丝	食谱
豌豆糯米粥	食谱
豌豆红糖粥	食谱
菠萝蒿笋	食谱
蒿笋炒山药	食谱
绿豆芽葛笋炒沙丁鱼片	食谱
莴笋子粥	食谱
鱼腥草拌蒿笋	食谱
水梨西瓜羹	食谱
冰糖西瓜	食谱
西瓜炒蛋	食谱
瓜皮赤豆茶	食谱
西瓜蜜汁	食谱
西红柿牛奶羹	食谱
锅塌西红柿	食谱
八宝西红柿	食谱
黑木耳香葱爆河虾	食谱
豌豆炒虾仁	食谱
虾米粥	食谱
四珍虾丸	食谱
香菇牛肉粥	食谱
香菇蒸鲤鱼	食谱
香菇扒菜心	食谱
枸杞子香菇蒸白缮	食谱
香菇饮	食谱
油炸香蕉夹	食谱
香蕉糯米粥	食谱
冰糖炖香蕉	食谱
鸡汁豆腐烧小白菜	食谱
紫菜小白菜海米卷	食谱
鸡脯扒小白菜	食谱
白菜薏仁粥	食谱
桂圆小米板栗粥	食谱
干贝小米粥	食谱
芹菜小米粥	食谱
羊骨粟米粥	食谱
小米麻子粥	食谱
党参小米粥	食谱
奶油杏仁香蕉	食谱
杏仁豆腐	食谱
山药杏仁粥	食谱
桑杏炖猪肺	食谱
白果全鸭	食谱
玉米煲老鸭	食谱
虫草全鸭	食谱
白菜鸡蛋麦片	食谱
羊方藏鱼	食谱
萝卜蒜苗羊肉汤	食谱
枸杞子炖羊肉	食谱
炮洋葱	食谱
炒洋葱丝	食谱
洋葱肉片	食谱
洋葱红枣汤	食谱
洋葱米粥	食谱
椰汁咖哩饭	食谱
椰子鸡块	食谱
燕窝椰子鸡汤	食谱
银耳樱桃粥	食谱
银耳莲子羹	食谱
百合银耳粥	食谱
香葱银耳羹	食谱
银耳煎双草	食谱
樱桃甜汤	食谱
樱桃酱	食谱
油菜炒虾仁	食谱
油菜蒸饭	食谱
菜子甘草饮	食谱
菜子肉桂丸	食谱
排骨玉米	食谱
红薯米粥	食谱
玉米沙拉	食谱
香卤什锦蔬菜	食谱
核桃芝麻扁豆泥	食谱
百合芝麻煲猪心	食谱
芝麻首乌杞子丸	食谱
芝麻聪脑汤	食谱
芝麻丸	食谱
酸笋滑肉咸蛋汤	食谱
冬瓜肉片汤	食谱
阿胶炖肉	食谱
北沙参炖猪肉	食谱
竹笋米粥药膳	食谱
炒双鲜	食谱
小炒岷笋	食谱
红豆竹笋汤	食谱
蜜拌春笋	食谱
鱼丝紫菜粥	食谱
紫菜蛋皮卷	食谱
仙人掌紫菜降压汤	食谱
薄荷	食材
当归	食材
党参	食材
胡桃	食材
辛夷	食材
猪胆	食材
陈皮	食材
赤小豆	食材
川芎	食材
独活	食材
茯苓	食材
枸杞子	食材
桂枝	食材
海参	食材
海藻	食材
红花	食材
黄鳝	食材
牛膝	食材
羌活	食材
桑枝	食材
土鳖虫	食材
威灵仙	食材
乌头	食材
荸荠	食材
麻仁	食材
沙参	食材
半夏	食材
磁石	食材
煅龙骨	食材
胡桃肉	食材
橘红	食材
龙胆草	食材
龙眼肉	食材
麦冬	食材
石菖蒲	食材
竹茹	食材
阿胶粉	食材
鹌鹑蛋	食材
冬瓜子	食材
覆盆子	食材
蛤蚧粉	食材
红糖	食材
山楂肉	食材
甜酒	食材
乌贼肉	食材
五味子	食材
鲜藕	食材
鲜芹菜	食材
鲜紫河车	食材
远志	食材
猪瘦肉	食材
白参	食材
白茅根	食材
白术	食材
茶叶	食材
淡菜	食材
旱莲草	食材
鲜荸荠	食材
豆浆	食材
甘草	食材
橘络	食材
橘皮	食材
母鸡	食材
丝瓜络	食材
通草	食材
莴苣子	食材
补骨脂	食材
附子	食材
干姜	食材
龟甲	食材
海蜇	食材
沙苑子	食材
白萝卜	食材
贝母	食材
葱白	食材
大蒜	食材
佛手	食材
蛤蚧	食材
核桃肉	食材
红参	食材
荆芥	食材
青笋	食材
柿饼	食材
丝瓜花	食材
杏仁	食材
柚子	食材
猪腰	食材
炒白扁豆	食材
车前草	食材
鸡蛋清	食材
鸡冠花	食材
马鞭草	食材
藕汁	食材
虾米	食材
香干	食材
羊肝	食材
银杏	食材
银杏仁	食材
白芍	食材
冰糖	食材
车前子	食材
浮小麦	食材
红枣	食材
鸡	食材
鲢鱼	食材
龙眼	食材
白苣	食材
扁豆	食材
番茄	食材
高粱米	食材
莱菔	食材
茉莉	食材
平菇	食材
桃子	食材
竹沥	食材
赤豆	食材
豆腐	食材
木槿花	食材
丁香	食材
豆蔻	食材
苦菜	食材
石膏	食材
枳壳	食材
菖蒲	食材
川贝	食材
黄牛肉	食材
金橘	食材
苦丁茶	食材
鲤鱼脑	食材
绿茶	食材
秋梨	食材
羊肾	食材
柘根	食材
川椒	食材
杜仲	食材
地黄	食材
冬虫夏草	食材
鹿角胶	食材
鸭	食材
川贝母	食材
淡豆豉	食材
狗肉	食材
厚朴	食材
羚羊角	食材
麻黄	食材
羊肺	食材
饴糖	食材
浙贝母	食材
竹叶	食材
枇杷叶	食材
生山楂	食材
茵陈	食材
银花	食材
地骨皮	食材
葛花	食材
鸡蛋花	食材
山栀子	食材
知母	食材
鲍鱼	食材
橘子	食材
牛奶	食材
白扁豆	食材
扁豆花	食材
豆豉	食材
葛根	食材
蔓荆子	食材
丝瓜皮	食材
西瓜翠衣	食材
刀鱼	食材
干贝	食材
龟肉	食材
鳜鱼	食材
牛羊脊髓	食材
白胡椒	食材
苍术	食材
草豆蔻	食材
草果	食材
赤芍	食材
厚朴花	食材
黄花菜	食材
鹿角片	食材
罗布麻	食材
青皮	食材
山栀	食材
白藕	食材
老鸭	食材
雪梨	食材
大黄	食材
丹参	食材
鸡骨草	食材
茉莉花	食材
熟大黄	食材
枳实	食材
炒麦芽	食材
刺梨	食材
赤砂糖	食材
鸽	食材
麻雀	食材
苋菜	食材
对虾	食材
柳叶	食材
乌龟	食材
香椿	食材
淡竹叶	食材
防风	食材
藁本	食材
枸杞叶	食材
莲子心	食材
水牛角	食材
玄参	食材
牛肝	食材
乌鸡	食材
藿香叶	食材
萹蓄	食材
金钱草	食材
牡蛎粉	食材
藕节	食材
小蓟	食材
高良姜	食材
鸽蛋	食材
怀山药	食材
蝮蛇	食材
首乌	食材
鲜白茅根	食材
鲜芦根	食材
玳玳花	食材
冬瓜皮	食材
连翘	食材
生甘草梢	食材
海蛤壳	食材
绿萼梅	食材
生牡蛎	食材
天冬	食材
谷精草	食材
槐叶	食材
栀子仁	食材
佛手柑	食材
韭菜子	食材
马兰	食材
白鸽	食材
百药煎	食材
鳖甲	食材
甘菊	食材
海螵蛸	食材
黄粟米	食材
荆芥穗	食材
净花椒	食材
净小茴香	食材
净芝麻	食材
橘饼	食材
炮干姜	食材
何首乌	食材
青蒿	食材
合欢花	食材
姜汁	食材
鸭梨	食材
柴胡	食材
仙人掌	食材
钩藤	食材
乌贼骨	食材
大茴香	食材
刀豆	食材
益智仁	食材
艾叶	食材
凌霄花	食材
乳鸽	食材
鲜韭菜	食材
延胡	食材
月季花	食材
白菜根	食材
白芷	食材
毛蛋	食材
牛脑髓	食材
元胡粉	食材
白鸭肉	食材
萆薢	食材
蚕沙	食材
防己	食材
黄柏	食材
大白菜	食材
山慈菇	食材
神曲	食材
炙甘草	食材
水梨	食材
天花粉	食材
莼菜	食材
黄豆芽	食材
白果	食材
蝉蜕	食材
诃子肉	食材
核桃仁	食材
蚌肉	食材
柚子皮	食材
雀肉	食材
小麦麸	食材
瓜蒌	食材
米酒	食材
猪心肉	食材
柑	食材
柑皮	食材
鸡蛋黄	食材
蚕蛹	食材
松子仁	食材
绿豆衣	食材
鲳鱼	食材
橙汁	食材
大小蓟	食材
丹皮	食材
肥肠	食材
枸杞苗	食材
瓜蒌根	食材
滑石	食材
黄芩	食材
老母鸡	食材
玫瑰	食材
青黛	食材
桑白皮	食材
田七	食材
栀子花	食材
紫草	食材
大麦	食材
黄花鱼	食材
巴戟天	食材
橙	食材
龟甲胶	食材
醋	食材
蛋黄	食材
动物肝	食材
坚果类	食材
乳类	食材
夜明砂	食材
莲肉	食材
螺蛳	食材
田螺	食材
木棉花	食材
芋头	食材
紫苏叶	食材
柏子仁	食材
蒺藜	食材
青木香	食材
苇根	食材
草菇	食材
炒鸡冠花	食材
红茶汁	食材
栗子仁	食材
茜草根	食材
肉桂粉	食材
鲜茅根	食材
鲜藕节	食材
鳙鱼头	食材
鳖肉	食材
河蚌	食材
牛蒡	食材
苍耳子	食材
桑耳	食材
无花果	食材
鸽肉	食材
野菊花	食材
海蜇头	食材
牛筋	食材
全蝎	食材
羊肚	食材
胆腑郁热	证机概要
肺气虚弱	证机概要
肺失宣降	证机概要
风热犯肺	证机概要
健运失职	证机概要
脾气虚弱	证机概要
脾胃湿热	证机概要
上犯鼻窍	证机概要
湿浊内生	证机概要
无力托邪	证机概要
邪热循经上壅鼻窍	证机概要
邪滞鼻窍	证机概要
循经上犯鼻窍	证机概要
循经上蒸鼻窍	证机概要
闭阻经络气血	证机概要
闭阻经脉	证机概要
闭阻经脉气血	证机概要
闭阻气血	证机概要
风寒夹湿留滞	证机概要
风夹寒湿	证机概要
风湿夹寒留滞	证机概要
风湿热邪壅滞经脉	证机概要
肝肾亏损	证机概要
筋脉失于濡养	证机概要
留滞肌肤	证机概要
留滞经脉	证机概要
气血闭阻不通	证机概要
痰瘀互结	证机概要
肠道失荣	证机概要
肠道失养	证机概要
肠腑燥热	证机概要
传导失司	证机概要
肺脾气虚	证机概要
腑气不通	证机概要
津伤便结	证机概要
凝滞胃肠	证机概要
气机郁滞	证机概要
血液亏虚	证机概要
阳气虚衰	证机概要
阴寒内结	证机概要
阴寒内盛	证机概要
阴液不足	证机概要
不能上济于心	证机概要
不能下交于肾	证机概要
肝郁化火	证机概要
脾虚血亏	证机概要
扰动心神	证机概要
上扰心神	证机概要
神不安舍	证机概要
神魂不安	证机概要
肾水亏虚	证机概要
湿食生痰	证机概要
心胆虚怯	证机概要
心火炽盛	证机概要
心神失养	证机概要
郁痰化热	证机概要
胞脉失于温煦	证机概要
不能化气行水	证机概要
不能摄精成孕	证机概要
产后余血未净之际	证机概要
冲任不能相资	证机概要
冲任虚衰	证机概要
肝气郁结	证机概要
寒湿滞于冲任	证机概要
命门火衰	证机概要
情志不畅	证机概要
涉水感寒	证机概要
湿壅胞脉	证机概要
疏泄失常	证机概要
损伤肾气	证机概要
邪与血结	证机概要
血气不和	证机概要
瘀阻胞脉	证机概要
胞脉空虚	证机概要
产妇素体阴虚	证机概要
产后胞宫	证机概要
产时气随血耗	证机概要
冲任失固	证机概要
寒邪乘虚而入	证机概要
结而成瘀	证机概要
久而化热	证机概要
迫血妄行	证机概要
其气益虚	证机概要
气滞血瘀	证机概要
热伤冲任	证机概要
素体虚弱	证机概要
损伤脾气	证机概要
新血难安	证机概要
血失统摄	证机概要
血为寒凝	证机概要
阴虚则内热	证机概要
营阴更亏	证机概要
瘀阻冲任	证机概要
中气虚陷	证机概要
复因产时失血耗气	证机概要
肝失条达	证机概要
气机不畅	证机概要
气血亏虚	证机概要
气血生化不足	证机概要
气血失调	证机概要
素体气血虚弱	证机概要
素性抑郁	证机概要
阻碍乳汁运行	证机概要
筋骨失养	证机概要
筋脉拘挛	证机概要
筋脉失养	证机概要
气血两虚	证机概要
肾阳衰微	证机概要
水不涵木	证机概要
髓海不充	证机概要
痰浊内扰	证机概要
肺病及肾	证机概要
肺气不降	证机概要
肺气不宣	证机概要
肺气亏虚	证机概要
肺气上逆	证机概要
肺气欲绝	证机概要
肺肾俱虚	证机概要
肺失清肃	证机概要
肺失肃降	证机概要
风寒袭肺	证机概要
肝郁气逆	证机概要
寒邪束表	证机概要
积湿生痰	证机概要
气失摄纳	证机概要
气失所主	证机概要
热郁于肺	证机概要
上冲犯肺	证机概要
痰热壅滞	证机概要
痰浊壅肺	证机概要
邪热蕴肺	证机概要
邪实气壅	证机概要
心肾阳衰	证机概要
虚火上炎	证机概要
蒸液成痰	证机概要
中阳不运	证机概要
带二脉	证机概要
带脉失约而致湿浊下注	证机概要
带下异常	证机概要
导致带下淋沥不断	证机概要
多因先天不足	证机概要
肝郁久化热	证机概要
寒湿下注伤及任	证机概要
火不生土	证机概要
脾生湿	证机概要
脾失健运	证机概要
脾虚生湿	证机概要
侵犯到脾	证机概要
色黄或赤白相兼	证机概要
湿气下注下焦	证机概要
素体脾虚或伤食损脾	证机概要
早婚多产	证机概要
表虚失固	证机概要
肺气不足	证机概要
汗液外泄	证机概要
火热逼津外泄	证机概要
津液外泄	证机概要
湿热内盛	证机概要
卫外失司	证机概要
邪热郁蒸	证机概要
心脾两虚	证机概要
虚火内扰脏腑	证机概要
血不养心	证机概要
阴虚不能制阳	证机概要
营卫不和	证机概要
久病伤阴	证机概要
炼液化痰	证机概要
气阴两伤	证机概要
气郁痰结	证机概要
扰乱心神	证机概要
上扰清窍	证机概要
神窍被扰	证机概要
生化乏源	证机概要
痰结蒙蔽神窍	证机概要
痰热互结	证机概要
五志化火	证机概要
虚火旺盛	证机概要
血气凝滞	证机概要
热毒入侵卫分	证机概要
热入营血	证机概要
肝气郁滞	证机概要
寒凝中阻	证机概要
横逆犯胃	证机概要
津液不足	证机概要
气机不利	证机概要
热积肠胃	证机概要
失于和降	证机概要
胃火上逆	证机概要
胃气上逆	证机概要
胃失和降	证机概要
胃失濡养	证机概要
中阳不足	证机概要
耳窍失养	证机概要
风热上扰	证机概要
蒙蔽清窍	证机概要
气虚血少	证机概要
气血郁结	证机概要
塞经阻窍	证机概要
肾精不足	证机概要
痰火郁结	证机概要
膏脂瘀积	证机概要
耗伤津液	证机概要
困遏脾运	证机概要
脾肾阳虚	证机概要
脾虚气弱	证机概要
气化温煦失职	证机概要
气郁不畅	证机概要
水湿内停	证机概要
痰湿内盛	证机概要
血行不利	证机概要
阳明火热内郁	证机概要
运化无力	证机概要
阻滞气机	证机概要
肺脾两虚	证机概要
肺肾阴伤	证机概要
肺失滋润	证机概要
精气虚竭	证机概要
水亏火旺	证机概要
阴伤及阳	证机概要
阴伤气耗	证机概要
阴虚肺燥	证机概要
肺不主气	证机概要
肺虚及肾	证机概要
肝风夹痰	证机概要
肝风内动	证机概要
寒邪袭肺	证机概要
金不生水	证机概要
蒙蔽神窍	证机概要
脾阳不足	证机概要
肾不纳气	证机概要
肾阳不足	证机概要
水湿运化功能失职	证机概要
痰湿内阻	证机概要
痰浊内盛	证机概要
痰阻气机	证机概要
邪气蕴肺	证机概要
郁而化热	证机概要
蒸腾气化功能失职	证机概要
肺经风热	证机概要
化湿生痰	证机概要
湿热蕴结	证机概要
痰瘀凝结于肌肤	证机概要
熏蒸肌肤	证机概要
饮食不节	证机概要
壅阻于肌肤	证机概要
风热外袭	证机概要
肌肤失养	证机概要
生风化燥	证机概要
湿热内生	证机概要
血热生风	证机概要
血虚肝旺	证机概要
郁于肌肤	证机概要
蕴结于肌肤	证机概要
毒邪炽盛	证机概要
毒邪久恋	证机概要
经络不通	证机概要
脓毒蚀骨	证机概要
湿热壅滞	证机概要
湿热瘀阻	证机概要
不能上乘于目	证机概要
肝阴血不足	证机概要
火热上炎	证机概要
津液大伤	证机概要
津液受损	证机概要
津液消亡	证机概要
目失所养	证机概要
脾病及肝	证机概要
脾病及心	证机概要
脾胃衰败	证机概要
脾胃虚弱	证机概要
脾虚日久	证机概要
气血生化乏源	证机概要
心火亢盛	证机概要
心阴受损	证机概要
阳虚水泛	证机概要
阴津大亏	证机概要
阴损及阳	证机概要
表卫失和	证机概要
表虚卫弱	证机概要
腠理闭塞	证机概要
肺气不清	证机概要
肺气失宣	证机概要
风寒乘袭	证机概要
风寒外束	证机概要
风热犯表	证机概要
气虚无力祛邪	证机概要
热郁肌腠	证机概要
湿热伤中	证机概要
暑湿遏表	证机概要
外受风热	证机概要
卫表失和	证机概要
阴亏津少	证机概要
发育迟缓	证机概要
肝旺乘脾	证机概要
骨弱髓少	证机概要
肾精亏损	证机概要
运化失司	证机概要
不能温运	证机概要
肝脾瘀结	证机概要
肝肾阴虚	证机概要
肝郁气滞	证机概要
寒水内停	证机概要
津液失布	证机概要
络脉滞涩	证机概要
脾阳不振	证机概要
脾运不健	证机概要
湿热壅盛	证机概要
湿邪困遏	证机概要
湿浊中阻	证机概要
水气停留	证机概要
水湿内聚	证机概要
蕴结中焦	证机概要
浊水内停	证机概要
肺失润降	证机概要
风燥伤肺	证机概要
肝郁不达	证机概要
脾湿生痰	证机概要
气不布津	证机概要
气郁化火	证机概要
上逆犯肺	证机概要
上渍于肺	证机概要
肃降无权	证机概要
痰热郁肺	证机概要
痰湿久蕴	证机概要
停而为饮	证机概要
虚热内灼	证机概要
壅遏肺气	证机概要
壅遏气道	证机概要
壅阻肺气	证机概要
燥热灼津	证机概要
胆汁不循常道	证机概要
胆汁泛溢	证机概要
肝胆失疏	证机概要
肝胆失于疏泄	证机概要
肝脾不调	证机概要
寒湿滞留	证机概要
黄疸日久	证机概要
积块留着	证机概要
困阻中焦	证机概要
脾胃不和	证机概要
湿遏热伏	证机概要
湿热留恋	证机概要
湿热砂石郁滞	证机概要
湿热熏蒸	证机概要
湿滞残留	证机概要
疏运失职	证机概要
壅滞肝胆	证机概要
余邪未清	证机概要
中阳不振	证机概要
痹阻脉络	证机概要
虫积	证机概要
肝失疏泄	证机概要
积而成块	证机概要
瘕积日久	证机概要
气聚成结	证机概要
气聚腹中	证机概要
气血衰少	证机概要
痰浊交阻	证机概要
瘀结不消	证机概要
正气渐损	证机概要
中虚失运	证机概要
脾胃运化失常	证机概要
气机阻滞	证机概要
日久化热	证机概要
乳食停聚	证机概要
食积不化	证机概要
膀胱涩滞	证机概要
膀胱失约	证机概要
溺窍不利	证机概要
溺窍失濡	证机概要
气化无权	证机概要
肾阳虚衰	证机概要
肾阴不足	证机概要
湿热下注	证机概要
膀胱气化失司	证机概要
精关不固	证机概要
迫精外出	证机概要
迫精外泄	证机概要
气血瘀滞	证机概要
肾阳虚损	证机概要
湿热蕴结下焦	证机概要
虚火扰及精室	证机概要
阴虚火旺	证机概要
瘀血败精阻于精室	证机概要
动风伤津	证机概要
风寒湿邪	证机概要
肝热炽盛	证机概要
筋脉失和	证机概要
侵于肌腠	证机概要
热扰心营	证机概要
热盛伤津	证机概要
阳明胃热亢盛	证机概要
壅滞经络	证机概要
灼伤阴津	证机概要
肝郁不舒	证机概要
肝郁肺痹	证机概要
内闭神机	证机概要
怒而气上	证机概要
气机上逆	证机概要
气逆于上	证机概要
气随血脱	证机概要
清窍闭塞	证机概要
清阳不升	证机概要
上闭清窍	证机概要
神明失养	证机概要
食滞中脘	证机概要
痰随气升	证机概要
菀阻清窍	证机概要
胃气不降	证机概要
血出过多	证机概要
血随气升	证机概要
壅阻心胸	证机概要
元气素虚	证机概要
不思饮食	证机概要
肠胃积热	证机概要
脾不运化	证机概要
平素体虚	证机概要
气机阻塞	证机概要
清气不升	证机概要
湿热内蕴	证机概要
食滞胃肠	证机概要
嗜食辛辣	证机概要
宿食内积	证机概要
损伤胃阴	证机概要
熏蒸于上	证机概要
浊气上逆	证机概要
浊阴不降	证机概要
寒湿上渍口舌	证机概要
久病伤脾	证机概要
脾气虚损	证机概要
脾胃郁久化热	证机概要
上熏灼口	证机概要
上渍口舌	证机概要
湿热上蒸	证机概要
时毒之邪	证机概要
水不制火	证机概要
水湿不运	证机概要
心肾阴虚	证机概要
虚火上浮	证机概要
血虚阴亏	证机概要
熏蒸口舌	证机概要
兼有肾虚	证机概要
脾肾两虚	证机概要
脾肾气虚	证机概要
脾虚为主	证机概要
日久成石	证机概要
下焦不畅	证机概要
下焦不利	证机概要
以脾虚为主	证机概要
灼伤脉络	证机概要
病久伤阴	证机概要
病久元气不支	证机概要
肝肾亏虚	证机概要
溃后毒邪内陷	证机概要
气血不足	证机概要
肾亏骼空	证机概要
痰浊凝聚	证机概要
阴虚内热	证机概要
毒邪积聚	证机概要
兼热毒内蕴	证机概要
脾虚痰凝	证机概要
气血阴阳亏虚	证机概要
痰浊积聚	证机概要
邪热内盛	证机概要
阳虚寒凝	证机概要
瘀血内阻	证机概要
不能升清降浊	证机概要
脾气亏虚	证机概要
气化无力	证机概要
热邪郁积于肺	证机概要
湿热蕴结膀胱	证机概要
疏泄乏力	证机概要
水道不利	证机概要
水道不通	证机概要
阻塞尿道	证机概要
肝木乘土	证机概要
气血耗伤	证机概要
气滞痰凝	证机概要
下灼肾阴	证机概要
闭塞目之玄府	证机概要
风火交攻	证机概要
聚湿成痰	证机概要
目内玄府闭塞	证机概要
目之玄府闭塞	证机概要
脾虚不运	证机概要
气火上逆头目	证机概要
情志过激	证机概要
上冲头目	证机概要
水湿不化	证机概要
痰火上扰头目	证机概要
郁而化火	证机概要
导致不育	证机概要
精窍被阻	证机概要
疏泄无权	证机概要
思虑过度	证机概要
痰湿困脾	证机概要
阳气内虚	证机概要
郁久化热	证机概要
元阴不足	证机概要
蕴结下焦	证机概要
阻遏命门之火	证机概要
火不归原	证机概要
肾阳亏虚	证机概要
痰湿内蕴	证机概要
虚火内炽	证机概要
血行瘀滞	证机概要
血虚失养	证机概要
阴不配阳	证机概要
阴火内生	证机概要
阴虚阳盛	证机概要
壅遏化热	证机概要
瘀热内生	证机概要
中气不足	证机概要
寒湿内盛	证机概要
疟邪伏于少阳	证机概要
疟邪久留	证机概要
疟邪入侵	证机概要
疟邪与营卫相搏	证机概要
热炽于里	证机概要
热陷心包	证机概要
湿浊蒙蔽心窍	证机概要
素体阳虚	证机概要
阳热素盛	证机概要
与营卫相搏	证机概要
瘴毒内盛	证机概要
正邪交争	证机概要
积食内停	证机概要
脾胃气虚	证机概要
脾胃虚寒	证机概要
气机失调	证机概要
失于濡润	证机概要
失于温煦	证机概要
痰饮内停	证机概要
外邪犯胃	证机概要
胃阴不足	证机概要
阳气不足	证机概要
运化失职	证机概要
中焦气滞	证机概要
中焦阻滞	证机概要
导致神水留滞于目	证机概要
精血不能上濡目窍	证机概要
久病肝肾不足	证机概要
目中脉络不畅	证机概要
脾阳失于温养	证机概要
神水乏源	证机概要
神水受阻	证机概要
痰湿阻滞于目	证机概要
虚滞于目	证机概要
肝肾不足	证机概要
痰邪凝结	证机概要
疮口难敛	证机概要
肝郁胃热	证机概要
热毒炽盛	证机概要
肉腐成脓	证机概要
乳汁郁积	证机概要
正不胜邪	证机概要
久病耗伤阴血	证机概要
日久伤脾	证机概要
湿热浸淫	证机概要
蕴积肌肤	证机概要
蕴于肌肤	证机概要
致血虚生风化燥	证机概要
精血不足	证机概要
目睛失养	证机概要
目睛失于濡养	证机概要
内伤脾胃	证机概要
水湿上泛	证机概要
饮食肥甘	证机概要
病久伤脾	证机概要
术后伤身	证机概要
累及肺脏	证机概要
累及厥阴	证机概要
内犯气营	证机概要
透于肌表	证机概要
邪毒炽盛	证机概要
邪犯肺卫	证机概要
邪犯气营	证机概要
与内湿相搏	证机概要
与湿热相搏	证机概要
郁于肺脾不解	证机概要
风寒袭表	证机概要
风热袭表	证机概要
水液内停	证机概要
水液运行失常	证机概要
卫气不宣	证机概要
蒸化无力	证机概要
冲任失养	证机概要
刺痛拒按	证机概要
得暖痛减	证机概要
多因体虚脾胃素弱	证机概要
肝血瘀滞	证机概要
肝主藏血	证机概要
感受湿热之邪	证机概要
故发为痛经	证机概要
故渐成胁下痞块	证机概要
故情绪抑郁或急躁	证机概要
化源不足	证机概要
积于血海	证机概要
稽留于冲任	证机概要
经期血海溢泻	证机概要
经行之际	证机概要
经血不畅则致痛经	证机概要
气为血帅	证机概要
气血下注冲任	证机概要
气血虚弱	证机概要
日久不解	证机概要
势必更虚	证机概要
手足欠温	证机概要
疏泄失职	证机概要
素有湿热内蕴	证机概要
小腹喜温喜按	证机概要
胸胁胀闷	证机概要
虚滞作痛	证机概要
有别于血瘀症候	证机概要
瘀血停滞	证机概要
与血搏结	证机概要
走窜疼痛	证机概要
阻碍经血下行	证机概要
风寒上袭	证机概要
风热上袭	证机概要
肝经风火	证机概要
肝阳失敛上亢	证机概要
寒凝血滞	证机概要
络脉拘急	证机概要
络脉失养	证机概要
脉络瘀阻	证机概要
脑窍失养	证机概要
脑失清阳	证机概要
脑失所养	证机概要
气血不畅	证机概要
气血不营	证机概要
气血逆乱	证机概要
气壅脉满	证机概要
侵扰清空	证机概要
清阳不布	证机概要
清阳受扰	证机概要
湿蒙脑窍	证机概要
痰阻脑脉	证机概要
营血亏损	证机概要
肺受热灼	证机概要
脾虚不健	证机概要
气虚血瘀	证机概要
气血运行受阻	证机概要
湿热壅阻经络	证机概要
阴津耗伤	证机概要
阴精不足	证机概要
阻滞经络	证机概要
肝气犯胃	证机概要
寒凝胃脘	证机概要
寒邪乘脾	证机概要
脉络壅滞	证机概要
濡养失司	证机概要
胃气壅滞	证机概要
胃气阻滞	证机概要
饮食积滞	证机概要
瘀血阻络	证机概要
阻遏阳气	证机概要
肺脏燥热	证机概要
气阴不足	证机概要
肾失固摄	证机概要
肾阴亏虚	证机概要
失于固摄	证机概要
胃火内炽	证机概要
胃热消谷	证机概要
火热邪毒上攻口舌	证机概要
火热循经上炎	证机概要
脾胃蕴热	证机概要
热蕴心脾	证机概要
上炎口舌	证机概要
肾阴亏损	证机概要
肺气郁闭	证机概要
肺肾两虚	证机概要
肺肾摄纳失常	证机概要
肺失宣畅	证机概要
肺虚不能主气	证机概要
风邪引触	证机概要
复感风寒	证机概要
寒痰伏肺	证机概要
津凝为痰	证机概要
精气亏乏	证机概要
脾虚健运失权	证机概要
气不归原	证机概要
气不化津	证机概要
摄纳失常	证机概要
升降失司	证机概要
痰气瘀阻	证机概要
痰热壅肺	证机概要
痰热蕴肺	证机概要
痰升气阻	证机概要
痰饮蕴肺	证机概要
痰浊伏肺	证机概要
哮病久发	证机概要
哮病日久	证机概要
壅阻气道	证机概要
遇感触发	证机概要
肝络痹阻	证机概要
肝络失养	证机概要
肝肾阴亏	证机概要
精血耗伤	证机概要
络脉失和	证机概要
肠腑传导失常	证机概要
寒湿中阻	证机概要
横逆侮脾	证机概要
困遏脾阳	证机概要
脾胃运化失职	证机概要
湿热阻滞	证机概要
食积胃肠	证机概要
耗伤气阴	证机概要
气阴两虚	证机概要
扰及心神	证机概要
上凌于心	证机概要
水饮内停	证机概要
痰郁化火	证机概要
邪毒犯心	证机概要
心脉瘀阻	证机概要
心血亏耗	证机概要
心阳被遏	证机概要
心阳虚衰	证机概要
虚火内动	证机概要
脉络阻滞	证机概要
气机痹阻	证机概要
气血痹阻	证机概要
水不济火	证机概要
痰浊盘踞	证机概要
心脉不畅	证机概要
心脉不和	证机概要
心气不足	证机概要
心失所养	证机概要
心阳不振	证机概要
胸阳不振	证机概要
胸阳失展	证机概要
血脉不畅	证机概要
阴寒凝滞	证机概要
阴血亏耗	证机概要
肺失清润	证机概要
肺阴亏虚	证机概要
肝血亏虚	证机概要
肝阴不足	证机概要
固摄无权	证机概要
脾胃阴伤	证机概要
脾虚运化失司	证机概要
上扰清空	证机概要
肾气不充	证机概要
失于濡养	证机概要
卫外不固	证机概要
温煦乏力	证机概要
心气亏虚	证机概要
心失濡养	证机概要
心血亏虚	证机概要
心阴亏虚	证机概要
阳亢于上	证机概要
腰府失养	证机概要
运化失常	证机概要
运血无力	证机概要
中阳亏虚	证机概要
风火上扰	证机概要
肝阳上亢	证机概要
髓海不足	证机概要
痰浊蒙蔽清窍	证机概要
肺络受损	证机概要
肝火横逆	证机概要
络损血溢	证机概要
脉络受损	证机概要
木火刑金	证机概要
气不摄血	证机概要
气虚不摄	证机概要
热伤胃络	证机概要
热伤阴络	证机概要
热壅经络	证机概要
上溢清窍	证机概要
肾虚不固	证机概要
统摄无力	证机概要
统血无力	证机概要
统血无权	证机概要
胃火上炎	证机概要
胃络损伤	证机概要
胃热内郁	证机概要
虚火炽盛	证机概要
虚火内灼	证机概要
虚火灼肺	证机概要
血去气伤	证机概要
血热妄行	证机概要
血渗膀胱	证机概要
血失藏摄	证机概要
血液外溢	证机概要
血溢肠道	证机概要
血溢肌腠	证机概要
血溢清窍	证机概要
血溢胃肠	证机概要
循经上犯	证机概要
燥热伤肺	证机概要
中焦虚寒	证机概要
中气亏虚	证机概要
灼伤络脉	证机概要
灼伤血络	证机概要
乘脾犯胃	证机概要
肝失调达	证机概要
纳食减少	证机概要
脾胃失和	证机概要
脾胃阴虚	证机概要
水谷受纳运化失常	证机概要
脏腑失养	证机概要
精气虚冷	证机概要
气血乏源	证机概要
湿热下注肝经	证机概要
血行不畅	证机概要
宗筋经络失畅	证机概要
宗筋失养	证机概要
宗筋所聚无能	证机概要
寒湿邪气侵袭腰部	证机概要
筋脉拘急	证机概要
气血阻滞	证机概要
气血阻滞不通	证机概要
肾精亏虚	证机概要
腰部失养	证机概要
瘀血阻滞	证机概要
失于温养	证机概要
食道闭塞	证机概要
痰湿壅阻	证机概要
通降失司	证机概要
虚火上逆	证机概要
肝血不足	证机概要
目失濡养	证机概要
封藏失职	证机概要
君相火动	证机概要
迫精妄泄	证机概要
气不摄精	证机概要
肾元虚衰	证机概要
下扰精室	证机概要
膀胱闭藏失司	证机概要
闭藏失司	证机概要
不能温养膀胱	证机概要
肝经湿热郁结	证机概要
脾肺气虚	证机概要
上虚不能制下	证机概要
湿热下迫膀胱	证机概要
水道约束无权	证机概要
水火不济	证机概要
下元虚寒	证机概要
心肾不交	证机概要
风寒外袭	证机概要
风热客表	证机概要
风邪侵袭	证机概要
复感外邪	证机概要
胃肠积热	证机概要
搏结成瘿	证机概要
凝结颈前	证机概要
气火内结日久	证机概要
痰气交阻	证机概要
痰浊壅阻	证机概要
心肝之阴耗伤	证机概要
血脉瘀滞	证机概要
壅结颈前	证机概要
热毒内攻	证机概要
伤气凝血	证机概要
火毒凝结	证机概要
热盛肉腐	证机概要
邪毒久耗	证机概要
阴液大亏	证机概要
气郁痰凝	证机概要
阴不涵阳	证机概要
阴精亏虚	证机概要
营阴暗耗	证机概要
阻滞胸咽	证机概要
暗耗阴血	证机概要
冲任不足	证机概要
冲任亏虚而见相关证候	证机概要
冲任血海亏虚	证机概要
导致经血妄行	证机概要
导致瘀血内阻	证机概要
跌仆	证机概要
多因寒邪侵犯血脉	证机概要
多因外感温热之邪	证机概要
多因外伤	证机概要
故出血紫黯	证机概要
故见月经色黯有血块	证机概要
精血不充	证机概要
久病体虚	证机概要
劳累过度	证机概要
面色晦暗	证机概要
年老体弱	证机概要
迫及血分	证机概要
气化等功能	证机概要
舌淡	证机概要
肾气不足	证机概要
肾虚精亏血少	证机概要
遂致月经后期而至	证机概要
遂致月经量少	证机概要
头晕耳鸣	证机概要
先天肾气不足	证机概要
腰膝酸软	证机概要
营养不足	证机概要
有别于血瘀	证机概要
瘀血阻塞脉络	证机概要
精液不固	证机概要
扰动精室	证机概要
肾气亏虚	证机概要
心脾失养	证机概要
虚火妄动	证机概要
毒热炽盛	证机概要
风温邪毒袭表	证机概要
结于腮部	证机概要
气血凝滞不通	证机概要
气血相搏	证机概要
少阳枢机不利	证机概要
壅阻少阳	证机概要
风热下迫	证机概要
脾虚气陷	证机概要
湿热下迫大肠	证机概要
血溢脉外	证机概要
痔核脱出	证机概要
灼伤肠络	证机概要
鼻窍不通	证机概要
风邪外袭	证机概要
肝经火盛	证机概要
积于鼓室	证机概要
痞塞耳窍	证机概要
肾精亏耗	证机概要
肾元亏虚	证机概要
湿热搏结于耳	证机概要
首先犯肺	证机概要
水道与脉络不畅	证机概要
水湿泛滥	证机概要
外感热邪内传	证机概要
壅阻耳窍	证机概要
阻隔耳窍	证机概要
风阳上扰	证机概要
化风上冲	证机概要
脉络闭阻	证机概要
神明散乱	证机概要
痰热内闭清窍	证机概要
痰湿蒙塞心神	证机概要
元气败脱	证机概要